{
  "field": [
    "##############",
    "#............#",
    "#............#",
    "#....#.......#",
    "#...#.#......#",
    "#...##.......#",
    "#.....#..#...#",
    "#......#..#..#",
    "#....#..#....#",
    "#......#.#...#",
    "#.......#....#",
    "#.....#......#",
    "#............#",
    "##############"
  ],

  "initial_snake_length": 1,
  "max_step_limit": 36,

  "rewards": {
    "timestep": 0,
    "ate_fruit": 1,
    "died": -1
  }
}